0000000220000000000000000000000000000000000000000000000000000000000000000000000000000000000000000000000000000000000000000000000000000000000000000000000000000000000000000000000000000000000000000000000000000000000000
0000000020000000000000000000002200000000000000000000222000000000022000000000000002000000000002000000000002200000000000000002000000000002000000000000022000000000000020000000000000020000000000200000000000000000000000
00000000000000000000000020000000000000002200000000000000000000000000000000002222000000000022200000000002000000000000h0220000000002000000000022200000000000000002200000000000000020000000000020000000000000090000000000
0022000000000000000000000777000000000000000000000000000000000022200000000000000000220000000000022200000000000002220777700000000000022000000000000000002200000000000000022200007777700000020000000022000000000000000000
00000000000000000000000007s7000000000000000000000000000000000000000000000000000000000000000000000000000000000000000777700000000000000000000000000000000000000000000000000000007777700077000000k00000000000000000000000
000000000000000000000000000000000000000000000000000000000000000000000000000000000000000000000000000000000000000000000000000000000000000000000000000000000000000000000000077700777770000000000l000000000000000000000000
0000000000000000000000003433000000000007770000000000000000000000000000000000000000000000000000000000000000000000000000000000000000000000000000000077700000000777000000000777004440000033000030000000000000000000000000
0000000000000000000000000000003400000007770000000000000000000000777000000000044000777770000000000000000000000000330000000000000000000000000000000000000000000777000000000000330000000000000330000000000000000000000000
0000000000000000000000000000000000030000000000000007000000000000777000033000000000777770000000000000000000343000000077700000000000000000300033000040007770000000000000300430005000000000003330000000000000000000000000
0000000000000000000000000000000000000000000033000077700000000000000000000000000000777770000000000003430000000000500000000000000000000003300033300000000000000000003400000000008000000000033330000000000000000000000000
000000000000000000005000000000000000003300000000077777g000000000003000000003430000000500000000330000000007700000800003330000500000000333300033330000000000000033000000000000008000000000333330000000000000000000000000
0000000000666006000080000660m06600600000000000666000000000000000066006m00000000000000800066600m00060006070066000800660m006008066660333333000333330600666m66600000006600m0600008660000663333330000666600000000000000000
1111111111111111111111111111111111111111111111111111111000000000111111111111111001111111111111111111111111111111111111111111111111111111100011111111111111111111111111111111111111111111111111111111111111111111111111
1111111111111111111111111111111111111111111111111111111000000000111111111111111001111111111111111111111111111111111111111111111111111111100011111111111111111111111111111111111111111111111111111111111111111111111111